NO ./texture/north.xpm
SO ./texture/south.xpm
WE ./texture/west.xpm
EA ./texture/east.xpm

F 204,255,255
C 255,209,204

      1    111    1
     101  10S01  101
    10001  101  10001
   1000001 101 1000001
  100000001101100000001
 10000000001010000000001
1000001000000000001000001
 1000000000111000000000101
  100000001   1000000010001
   1000001     1000001001001
    10001       1000100000001
     101    1    1000000100001
     101    1    1000000100001
    10001       1000100000001
   1000001     1000001001001
  100000001   1000000010001
 1000000000111000000000101
1000001000000000001000001
 10000000001110000000001
  100000001   100000001
   1000001     1000001
    10001       10001
     101         101
      1111111111111
