NO ./texture/north.xpm
SO ./texture/south.xpm
WE ./texture/west.xpm
EA ./texture/east.xpm

C 204,102,0
F 0,128,255

       111
     1110111
    111000111 
   11100000111
  1110000000111
 111000000000111
11100000100000111
 111000000000111
  111000N000111
   11100000111
    111000111
     1110111
       111