NO    ./texture/north.xpm
        SO ./texture/south.xpm
        
        F 220     ,    100,10
WE      ./texture/west.xpm
 EA ./texture/east.xpm

C         225 ,30,0     


        1111111111111111111111111
        1000000000110000000000001
        1011000001110000000000001
        1001000000000000000000001
11111111101100000111000000000001
100000000011000001110111111111111
11110111111111011100000010001                                   
11110111111111011101010000001
11000000110101011100000010001             
10000000000000001101000010001
10000000000000000001010010001
11000001110101011111011110W0111
11110111 1110101 101111010001
11111111 1111111 111111111111

             


                              

                                    